PRAEFATIO . mvn

ι Β autem v. 95-130 sic claudit: aedis- adeteaiat —
ad nes — mores —- qsiezei — eenqerones - aduenerant —-
aqueae - [casem] - oblectent - saeiimt - mentiri —
capere - niis - bona loqui — ad nos — adeeessi — ad-
daea - scies - quis est -· respice - pessimis - odiosus
es - menum - inparis - quid aeis — dieis - ais -
arehinam.

' In altero cantico non discessi a B, nisi quod v. 250
clausulam separavi.

V. 448—464: sollieiieq; — neele - perhibemur - dicito -
capio — pueri — uite - caesa — seeeeosiui - aetate -
aeaerateqi exsequere - puer perio - (sisimile.

V. 551-630: eerrenis - elaea ροσε - inmersisse -
fae‘ - amator - metuit - ineenelissieeuen sit — eae - equ-i
dem — illie adiutabo — peribit - niodo — Hermeianeam —
saei - enare — eriere — capio - ui esi — abundat —
afflaret — eeeepaiee κ- acahlaeeditia — intuli - asticis —-
loqui - peterem - gieta - itales - ualeat — taus (fero
tuus in spatio versus praecedentis extant) - fere —- minas -·
operare — eei - introiehiame - eiefeeaat — mateyori -
fide — (layitii - dona — miserit - honori — eeeniai —
ilicet - esselis - nequid est - illie esi — obsereeehi —illic
ese - iniieno — dentibus —- ipsus - emerserat -promam —
dicere — lubido est - faeie - lubitum - caesa — ein-
cinnam - que hercles - aiiiei' — iam hercle - aenum —
ai eye — incuses — inerataq; —- peri —- omnim teus -
modo - eoaeaeilabo — noetio esi — uieeris - uicerim -
opitemm esi - hee est — belliqeraneleme —- deinum - 'sed
ayo - lieet.

V. 711-728: — eei isicem — exinani —- secundas -
eie peis — faeiat — ad uos - ludin istos - antaeo - ma-
qe's —- ezoiesius — uelem - intus — quispiam — te loquar -
quidm — soie-s stessi—mam — nobis - eqo idem.

De personarum notatione sufficiunt quae in apparatu

critico addidi. Sed deipsis personarum nominibus quaedam
paulo fusius exponenda sunt. Quamquam de Cuami nomina
Spengelius et post eum Kiasslingius cum aliis satis dixerunt,
item de (A)staphii nomine Fleckeisenus, nequa est quod

 

